-	ー
~	〜
.	。
,	、
;/	・
;.	…
;,	‥
;h	←
;j	↓
;k	↑
;l	→
;-	〜
;[	『
;]	』
[	「
]	」
va	ゔぁ
vi	ゔぃ
vu	ゔ
ve	ゔぇ
vo	ゔぉ
v'	ゔぁい
v,	ゔぉう
v.	ゔぇい
v;	ゔぁん
vq	ゔぉん
vj	ゔぇん
vx	ゔぃん
vya	ゔゃ
vyi	ゔぃ
vyu	ゔゅ
vye	ゔぇ
vyo	ゔょ
vha	ゔゃ
vhi	ゔぃ
vhu	ゔゅ
vhe	ゔぇ
vho	ゔょ
vh'	ゔぁい
vh,	ゔょう
vh.	ゔぇい
vhp	ゔゅう
vh;	ゔゃん
vhq	ゔょん
vhj	ゔぇん
vhk	ゔゅん
vhx	ゔぃん
qq	っ	q
vv	っ	v
ll	っ	l
xx	っ	x
kk	っ	k
cc	っ	c
gg	っ	g
ss	っ	s
zz	っ	z
jj	っ	j
tt	っ	t
dd	っ	d
hh	っ	h
ff	っ	f
bb	っ	b
pp	っ	p
mm	っ	m
yy	っ	y
rr	っ	r
ww	っ	w
www	w	ww
kya	きゃ
kyi	きぃ
kyu	きゅ
kye	きぇ
kyo	きょ
ky'	きゃい
ky,	きょう
ky.	きぇい
kyp	きゅう
ky;	きゃん
kyq	きょん
kyj	きぇん
kyk	きゅん
kyx	きぃん
kha	きゃ
khi	きぃ
khu	きゅ
khe	きぇ
kho	きょ
kh'	きゃい
kh,	きょう
kh.	きぇい
khp	きゅう
kh;	きゃん
khq	きょん
khj	きぇん
khk	きゅん
khx	きぃん
cna	きゃ
cni	きぃ
cnu	きゅ
cne	きぇ
cno	きょ
cn'	きゃい
cn,	きょう
cn.	きぇい
cnp	きゅう
cn;	きゃん
cnq	きょん
cnj	きぇん
cnk	きゅん
cnx	きぃん
gya	ぎゃ
gyi	ぎぃ
gyu	ぎゅ
gye	ぎぇ
gyo	ぎょ
gy'	ぎゃい
gy,	ぎょう
gy.	ぎぇい
gyp	ぎゅう
gy;	ぎゃん
gyq	ぎょん
gyj	ぎぇん
gyk	ぎゅん
gyx	ぎぃん
gna	ぎゃ
gni	ぎぃ
gnu	ぎゅ
gne	ぎぇ
gno	ぎょ
gn'	ぎゃい
gn,	ぎょう
gn.	ぎぇい
gnp	ぎゅう
gn;	ぎゃん
gnq	ぎょん
gnj	ぎぇん
gnk	ぎゅん
gnx	ぎぃん
sya	しゃ
syi	しぃ
syu	しゅ
sye	しぇ
syo	しょ
sy'	しゃい
sy,	しょう
sy.	しぇい
syp	しゅう
sy;	しゃん
syq	しょん
syj	しぇん
syk	しゅん
syx	しん
sha	しゃ
shi	し
shu	しゅ
she	しぇ
sho	しょ
sh'	しゃい
sh,	しょう
sh.	しぇい
shp	しゅう
sh;	しゃん
shq	しょん
shj	しぇん
shk	しゅん
shx	しん
zya	じゃ
zyi	じぃ
zyu	じゅ
zye	じぇ
zyo	じょ
zy'	じゃい
zy,	じょう
zy.	じぇい
zyp	じゅう
zy;	じゃん
zyq	じょん
zyj	じぇん
zyk	じゅん
zyx	じぃん
zha	じゃ
zhi	じぃ
zhu	じゅ
zhe	じぇ
zho	じょ
zh'	じゃい
zh,	じょう
zh.	じぇい
zhp	じゅう
zh;	じゃん
zhq	じょん
zhj	じぇん
zhk	じゅん
zhx	じぃん
tya	ちゃ
tyi	ちぃ
tyu	ちゅ
tye	ちぇ
tyo	ちょ
ty'	ちゃい
ty,	ちょう
ty.	ちぇい
typ	ちゅう
ty;	ちゃん
tyq	ちょん
tyj	ちぇん
tyk	ちゅん
tyx	ちぃん
tna	ちゃ
tni	ちぃ
tnu	ちゅ
tne	ちぇ
tno	ちょ
tn'	ちゃい
tn,	ちょう
tn.	ちぇい
tnp	ちゅう
tn;	ちゃん
tnq	ちょん
tnj	ちぇん
tnk	ちゅん
tnx	ちぃん
cha	ちゃ
chi	ち
chu	ちゅ
che	ちぇ
cho	ちょ
ch'	ちゃい
ch,	ちょう
ch.	ちぇい
chp	ちゅう
ch;	ちゃん
chq	ちょん
chj	ちぇん
chk	ちゅん
chx	ちん
cya	ちゃ
cyi	ちぃ
cyu	ちゅ
cye	ちぇ
cyo	ちょ
cy'	ちゃい
cy,	ちょう
cy.	ちぇい
cyp	ちゅう
cy;	ちゃん
cyq	ちょん
cyj	ちぇん
cyk	ちゅう
cyx	ちぃん
dya	ぢゃ
dyi	ぢぃ
dyu	ぢゅ
dye	ぢぇ
dyo	ぢょ
dy'	ぢゃい
dy,	ぢょう
dy.	ぢぇい
dyp	ぢゅう
dy;	ぢゃん
dyq	ぢょん
dyj	ぢぇん
dyk	ぢゅん
dyx	ぢぃん
dna	ぢゃ
dni	ぢぃ
dnu	ぢゅ
dne	ぢぇ
dno	ぢょ
dn'	ぢゃい
dn,	ぢょう
dn.	ぢぇい
dnp	ぢゅう
dn;	ぢゃん
dnq	ぢょん
dnj	ぢぇん
dnk	ぢゅん
dnx	ぢぃん
tsa	つぁ
tsi	つぃ
tsu	つ
tse	つぇ
tso	つぉ
ts'	つぁい
ts,	つぉう
ts.	つぇい
tsp	つう
ts;	つぁん
tsq	つぉん
tsj	つぇん
tsk	つん
tsx	つぃん
tha	てゃ
thi	てぃ
thu	てゅ
the	てぇ
tho	てょ
th'	てゃい
th,	てょう
th.	てぇい
thp	てゅう
th;	てゃん
thq	てょん
thj	てぇん
thk	てゅん
thx	てぃん
dha	でゃ
dhi	でぃ
dhu	でゅ
dhe	でぇ
dho	でょ
dh'	でゃい
dh,	でょう
dh.	でぇい
dhp	でゅう
dh;	でゃん
dhq	でょん
dhj	でぇん
dhk	でゅん
dhx	でぃん
twa	とぁ
twi	とぃ
twu	とぅ
twe	とぇ
two	とぉ
tw'	とぁい
tw,	とぉう
tw.	とぇい
twp	とぅう
tw;	とぁん
twq	とぉん
twj	とぇん
twk	とぅん
twx	とぃん
dwa	どぁ
dwi	どぃ
dwu	どぅ
dwe	どぇ
dwo	どぉ
dw'	どぁい
dw,	どぉう
dw.	どぇい
dwp	どぅう
dw;	どぁん
dwq	どぉん
dwj	どぇん
dwk	どぅん
dwx	どぃん
nya	にゃ
nyi	にぃ
nyu	にゅ
nye	にぇ
nyo	にょ
ny'	にゃい
ny,	にょう
ny.	にぇい
nyp	にゅう
ny;	にゃん
nyq	にょん
nyj	にぇん
nyk	にゅん
nyx	にぃん
nha	にゃ
nhi	にぃ
nhu	にゅ
nhe	にぇ
nho	にょ
nh'	にゃい
nh,	にょう
nh.	にぇい
nhp	にゅう
nh;	にゃん
nhq	にょん
nhj	にぇん
nhk	にゅん
nhx	にぃん
hya	ひゃ
hyi	ひぃ
hyu	ひゅ
hye	ひぇ
hyo	ひょ
hy'	ひゃい
hy,	ひょう
hy.	ひぇい
hyp	ひゅう
hy;	ひゃん
hyq	ひょん
hyj	ひぇん
hyk	ひゅん
hyx	ひぃん
hna	ひゃ
hni	ひぃ
hnu	ひゅ
hne	ひぇ
hno	ひょ
hn'	ひゃい
hn,	ひょう
hn.	ひぇい
hnp	ひゅう
hn;	ひゃん
hnq	ひょん
hnj	ひぇん
hnk	ひゅん
hnx	ひぃん
bya	びゃ
byi	びぃ
byu	びゅ
bye	びぇ
byo	びょ
by'	びゃい
by,	びょう
by.	びぇい
byp	びゅう
by;	びゃん
byq	びょん
byj	びぇん
byk	びゅん
byx	びぃん
bna	びゃ
bni	びぃ
bnu	びゅ
bne	びぇ
bno	びょ
bn'	びゃい
bn,	びょう
bn.	びぇい
bnp	びゅう
bn;	びゃん
bnq	びょん
bnj	びぇん
bnk	びゅん
bnx	びぃん
pya	ぴゃ
pyi	ぴぃ
pyu	ぴゅ
pye	ぴぇ
pyo	ぴょ
py'	ぴゃい
py,	ぴょう
py.	ぴぇい
pyp	ぴゅう
py;	ぴゃん
pyq	ぴょん
pyj	ぴぇん
pyk	ぴゅん
pyx	ぴぃん
pha	ぴゃ
phi	ぴぃ
phu	ぴゅ
phe	ぴぇ
pho	ぴょ
ph'	ぴゃい
ph,	ぴょう
ph.	ぴぇい
php	ぴゅう
ph;	ぴゃん
phq	ぴょん
phj	ぴぇん
phk	ぴゅん
phx	ぴぃん
fa	ふぁ
fi	ふぃ
fu	ふ
fe	ふぇ
fo	ふぉ
f'	ふぁい
f,	ふぉう
f.	ふぇい
fp	ふう
f;	ふぁん
fq	ふぉん
fj	ふぇん
fk	ふん
fx	ふぃん
fya	ふゃ
fyu	ふゅ
fyo	ふょ
fy'	ふゃい
fy,	ふょう
fyp	ふゅう
fy;	ふゃん
fyq	ふょん
fyk	ふゅん
fna	ふゃ
fnu	ふゅ
fno	ふょ
fn'	ふゃい
fn,	ふょう
fnp	ふゅう
fn;	ふゃん
fnq	ふょん
fnk	ふゅん
hwa	ふぁ
hwi	ふぃ
hwe	ふぇ
hwo	ふぉ
mya	みゃ
myi	みぃ
myu	みゅ
mye	みぇ
myo	みょ
my'	みゃい
my,	みょう
my.	みぇい
myp	みゅう
my;	みゃん
myq	みょん
myj	みぇん
myk	みゅん
myx	みぃん
mna	みゃ
mni	みぃ
mnu	みゅ
mne	みぇ
mno	みょ
mn'	みゃい
mn,	みょう
mn.	みぇい
mnp	みゅう
mn;	みゃん
mnq	みょん
mnj	みぇん
mnk	みゅん
mnx	みぃん
rya	りゃ
ryi	りぃ
ryu	りゅ
rye	りぇ
ryo	りょ
ry'	りゃい
ry,	りょう
ry.	りぇい
ryp	りゅう
ry;	りゃん
ryq	りょん
ryj	りぇん
ryk	りゅん
ryx	りぃん
rha	りゃ
rhi	りぃ
rhu	りゅ
rhe	りぇ
rho	りょ
rh'	りゃい
rh,	りょう
rh.	りぇい
rhp	りゅう
rh;	りゃん
rhq	りょん
rhj	りぇん
rhk	りゅん
rhx	りぃん
nn	ん
n	ん
xn	ん
a	あ
i	い
u	う
e	え
o	お
xa	ぁ
xi	ぃ
xu	ぅ
xe	ぇ
xo	ぉ
x'	ぁい
x,	ぉう
x.	ぇい
xp	ぅう
x;	ぁん
xq	ぉん
xj	ぇん
xk	ぅん
la	ぁ
li	ぃ
lu	ぅ
le	ぇ
lo	ぉ
l'	ぁい
l,	ぉう
l.	ぇい
lp	ぅう
l;	ぁん
lq	ぉん
lj	ぇん
lk	ぅん
lx	ぃん
lyi	ぃ
xyi	ぃ
xhi	ぃ
lye	ぇ
xye	ぇ
xhe	ぇ
ka	か
ki	き
ku	く
ke	け
ko	こ
k'	かい
k,	こう
k.	けい
kp	くう
k;	かん
kq	こん
kj	けん
kx	きん
xka	ヵ
xke	ヶ
lka	ヵ
lke	ヶ
ca	か
ci	き
cu	く
ce	け
co	こ
c'	かい
c,	こう
c.	けい
cp	くう
c;	かん
cq	こん
cj	けん
ck	くん
cx	きん
xca	ヵ
xce	ヶ
lca	ヵ
lce	ヶ
ga	が
gi	ぎ
gu	ぐ
ge	げ
go	ご
g'	がい
g,	ごう
g.	げい
gp	ぐう
g;	がん
gq	ごん
gj	げん
gk	ぐん
gx	ぎん
sa	さ
si	し
su	す
se	せ
so	そ
s'	さい
s,	そう
s.	せい
sp	すう
s;	さん
sq	そん
sj	せん
sk	すん
sx	しん
qa	くぁ
qi	くぃ
qu	く
qe	くぇ
qo	くぉ
q'	くぁい
q,	くぉう
q.	くぇい
qp	くう
q;	くぁん
qj	くぇん
qk	くん
qx	くぃん
kwa	くぁ
kwi	くぃ
kwu	くぅ
kwe	くぇ
kwo	くぉ
kw'	くぁい
kw,	くぉう
kw.	くぇい
kwp	くぅう
kw;	くぁん
kwq	くぉん
kwj	くぇん
kwk	くぅん
kwx	くぃん
cwa	くぁ
cwi	くぃ
cwu	くぅ
cwe	くぇ
cwo	くぉ
cw'	くぁい
cw,	くぉう
cw.	くぇい
cwp	くぅう
cw;	くぁん
cwq	くぉん
cwj	くぇん
cwk	くぅん
cwx	くぃん
gwa	ぐぁ
gwi	ぐぃ
gwu	ぐぅ
gwe	ぐぇ
gwo	ぐぉ
gw'	ぐぁい
gw,	ぐぉう
gw.	ぐぇい
gwp	ぐぅう
gw;	ぐぁん
gwq	ぐぉん
gwj	ぐぇん
gwk	ぐぅん
gwx	ぐぃん
za	ざ
zi	じ
zu	ず
ze	ぜ
zo	ぞ
z'	ざい
z,	ぞう
z.	ぜい
zp	ずう
z;	ざん
zq	ぞん
zj	ぜん
zk	ずん
zx	じん
ja	じゃ
ji	じ
ju	じゅ
je	じぇ
jo	じょ
j'	じゃい
j,	じょう
j.	じぇい
jp	じゅう
j;	じゃん
jq	じょん
jk	じゅん
jx	じん
jya	じゃ
jyi	じぃ
jyu	じゅ
jye	じぇ
jyo	じょ
jy'	じゃい
jy,	じょう
jy.	じぇい
jyp	じゅう
jy;	じゃん
jyq	じょん
jyj	じぇん
jyk	じゅん
jyx	じぃん
jha	じゃ
jhi	じぃ
jhu	じゅ
jhe	じぇ
jho	じょ
jh'	じゃい
jh,	じょう
jh.	じぇい
jhp	じゅう
jh;	じゃん
jhq	じょん
jhj	じぇん
jhk	じゅん
jhx	じぃん
ta	た
ti	ち
tu	つ
te	て
to	と
t'	たい
t,	とう
t.	てい
tp	つう
t;	たん
tq	とん
tj	てん
tk	つん
tx	ちん
da	だ
di	ぢ
du	づ
de	で
do	ど
d'	だい
d,	どう
d.	でい
dp	づう
d;	だん
dq	どん
dj	でん
dk	づん
dx	ぢん
xtu	っ
xtsu	っ
ltu	っ
ltsu	っ
na	な
ni	に
nu	ぬ
ne	ね
no	の
n'	ない
n,	のう
n.	ねい
np	ぬう
n;	なん
nq	のん
nj	ねん
nk	ぬん
nx	にん
ha	は
hi	ひ
hu	ふ
he	へ
ho	ほ
h'	はい
h,	ほう
h.	へい
hp	ふう
h;	はん
hq	ほん
hj	へん
hk	ふん
hx	ひん
ba	ば
bi	び
bu	ぶ
be	べ
bo	ぼ
b'	ばい
b,	ぼう
b.	べい
bp	ぶう
b;	ばん
bq	ぼん
bj	べん
bk	ぶん
bx	びん
pa	ぱ
pi	ぴ
pu	ぷ
pe	ぺ
po	ぽ
p'	ぱい
p,	ぽう
p.	ぺい
p;	ぱん
pq	ぽん
pj	ぺん
pk	ぷん
px	ぴん
ma	ま
mi	み
mu	む
me	め
mo	も
m'	まい
m,	もう
m.	めい
mp	むう
m;	まん
mq	もん
mj	めん
mk	むん
mx	みん
ya	や
yu	ゆ
ye	いぇ
yo	よ
y'	やい
y,	よう
y.	いぇい
yp	ゆう
y;	やん
yq	よん
yj	いぇん
yk	ゆん
xya	ゃ
xyu	ゅ
xyo	ょ
xy'	ゃい
xy,	ょう
xy.	ぇう
xyp	ょう
xy;	ゃん
xyq	ょん
xyj	ぇん
xyk	ゅん
xyx	ぃん
xha	ゃ
xhu	ゅ
xho	ょ
xh'	ゃい
xh,	ょう
xh.	ぇう
xhp	ょう
xh;	ゃん
xhq	ょん
xhj	ぇん
xhk	ゅん
xhx	ぃん
lya	ゃ
lyu	ゅ
lyo	ょ
ly'	ゃい
ly,	ょう
ly.	ぇう
lyp	ょう
ly;	ゃん
lyq	ょん
lyj	ぇん
lyk	ゅん
lyx	ぃん
lha	ゃ
lhu	ゅ
lho	ょ
lh'	ゃい
lh,	ょう
lh.	ぇう
lhp	ょう
lh;	ゃん
lhq	ょん
lhj	ぇん
lhk	ゅん
lhx	ぃん
wyi	ゐ
wye	ゑ
ra	ら
ri	り
ru	る
re	れ
ro	ろ
r'	らい
r,	ろう
r.	れい
rp	るう
r;	らん
rq	ろん
rj	れん
rk	るん
rx	りん
xwa	ゎ
lwa	ゎ
wa	わ
wi	うぃ
wu	う
we	うぇ
wo	を
w'	わい
w.	うぇい
wp	うう
w;	わん
wj	うぇん
wk	うん
wx	うぃん
wha	うぁ
whi	うぃ
whu	う
whe	うぇ
who	うぉ
wh'	うぁい
wh,	うぉう
wh.	うぇい
whp	うう
wh;	うぁん
whq	うぉん
whj	うぇん
whk	うん
whx	うぃん
:+1	👍
:-1	👎
:100	💯
:1234	🔢
:8ball	🎱
:ab:	🆎
:abacus	🧮
:abc:	🔤
:abcd	🔡
:accept	🉑
:accordion	🪗
:adhesive_bandage	🩹
:adult	🧑
:aerial_tramway	🚡
:airplane_arriving	🛬
:airplane_departure	🛫
:alarm_clock	⏰
:alien	👽
:ambulance	🚑
:amphora	🏺
:anatomical_heart	🫀
:anchor	⚓
:angel	👼
:anger	💢
:angry	😠
:anguished	😧
:ant	🐜
:apple	🍎
:aquarius	♒
:archery	🏹
:aries	♈
:arrow_double_down	⏬
:arrow_double_up	⏫
:arrow_down_small	🔽
:arrow_up_small	🔼
:arrows_clockwise	🔃
:arrows_counterclockwise	🔄
:art:	🎨
:articulated_lorry	🚛
:astonished	😲
:athletic_shoe	👟
:atm	🏧
:auto_rickshaw	🛺
:avocado	🥑
:axe	🪓
:baby:	👶
:baby_bottle	🍼
:baby_chick	🐤
:baby_symbol	🚼
:back:	🔙
:back_of_hand	🤚
:bacon	🥓
:badger	🦡
:badminton	🏸
:bagel	🥯
:baggage_claim	🛄
:baguette_bread	🥖
:bald	🦲
:ballet_shoes	🩰
:balloon	🎈
:bamboo	🎍
:banana	🍌
:banjo	🪕
:bank	🏦
:bar_chart	📊
:barber	💈
:baseball	⚾
:basket:	🧺
:basketball:	🏀
:basketball_player	⛹
:bat:	🦇
:bath:	🛀
:bathtub	🛁
:battery	🔋
:bear:	🐻
:bearded_person	🧔
:beaver	🦫
:bee:	🐝
:beer:	🍺
:beers	🍻
:beetle	🪲
:beginner	🔰
:bell:	🔔
:bell_pepper	🫑
:bento	🍱
:beverage_box	🧃
:bicyclist	🚴
:bike	🚲
:bikini	👙
:billed_cap	🧢
:bird	🐦
:birthday	🎂
:bison	🦬
:black_circle	⚫
:black_heart	🖤
:black_joker	🃏
:black_large_square	⬛
:black_medium_small_square	◾
:black_square_button	🔲
:blond_haired_person	👱
:blossom	🌼
:blowfish	🐡
:blue_book	📘
:blue_car	🚙
:blue_circle	🔵
:blue_heart	💙
:blue_square	🟦
:blueberries	🫐
:blush	😊
:boar	🐗
:bomb	💣
:bone	🦴
:book:	📖
:bookmark:	🔖
:bookmark_tabs	📑
:books	📚
:boom:	💥
:boomerang	🪃
:boot	👢
:bottle_with_popping_cork	🍾
:bouquet	💐
:bow:	🙇
:bow_and_arrow	🏹
:bowl_with_spoon	🥣
:bowling	🎳
:boxing_glove:	🥊
:boxing_gloves	🥊
:boy	👦
:brain	🧠
:bread	🍞
:breast_feeding	🤱
:bricks	🧱
:bridge_at_night	🌉
:briefcase	💼
:briefs	🩲
:broccoli	🥦
:broken_heart	💔
:broom	🧹
:brown_circle	🟤
:brown_heart	🤎
:brown_square	🟫
:bubble_tea	🧋
:bucket	🪣
:bug	🐛
:bulb	💡
:bullettrain_front	🚅
:bullettrain_side	🚄
:burrito	🌯
:bus:	🚌
:busstop	🚏
:bust_in_silhouette	👤
:busts_in_silhouette	👥
:butter:	🧈
:butterfly	🦋
:cactus	🌵
:cake	🍰
:calendar	📆
:call_me:	🤙
:call_me_hand	🤙
:calling	📲
:camel	🐫
:camera:	📷
:camera_with_flash	📸
:cancer	♋
:candy	🍬
:canned_food	🥫
:canoe	🛶
:capital_abcd	🔠
:capricorn	♑
:card_index	📇
:carousel_horse	🎠
:carpentry_saw	🪚
:carrot	🥕
:cartwheel	🤸
:cat2	🐈
:cat:	🐱
:cd	💿
:chair	🪑
:champagne:	🍾
:champagne_glass	🥂
:chart:	💹
:chart_with_downwards_trend	📉
:chart_with_upwards_trend	📈
:checkered_flag	🏁
:cheese:	🧀
:cheese_wedge	🧀
:cherries	🍒
:cherry_blossom	🌸
:chestnut	🌰
:chicken	🐔
:child:	🧒
:children_crossing	🚸
:chocolate_bar	🍫
:chopsticks	🥢
:christmas_tree	🎄
:church	⛪
:cinema	🎦
:circus_tent	🎪
:city_dusk	🌆
:city_sunrise	🌇
:city_sunset	🌇
:cl:	🆑
:clap:	👏
:clapper	🎬
:clinking_glass	🥂
:clipboard	📋
:clock1030	🕥
:clock10:	🕙
:clock1130	🕦
:clock11:	🕚
:clock1230	🕧
:clock12:	🕛
:clock130	🕜
:clock1:	🕐
:clock230	🕝
:clock2:	🕑
:clock330	🕞
:clock3:	🕒
:clock430	🕟
:clock4:	🕓
:clock530	🕠
:clock5:	🕔
:clock630	🕡
:clock6:	🕕
:clock730	🕢
:clock7:	🕖
:clock830	🕣
:clock8:	🕗
:clock930	🕤
:clock9:	🕘
:closed_book	📕
:closed_lock_with_key	🔐
:closed_umbrella	🌂
:clown:	🤡
:clown_face	🤡
:coat	🧥
:cockroach	🪳
:cocktail	🍸
:coconut	🥥
:coffee	☕
:coin	🪙
:cold_face	🥶
:cold_sweat	😰
:compass	🧭
:computer	💻
:confetti_ball	🎊
:confounded	😖
:confused	😕
:construction:	🚧
:construction_worker	👷
:convenience_store	🏪
:cookie	🍪
:cooking	🍳
:cool	🆒
:cop	👮
:corn	🌽
:couple:	👫
:couple_with_heart	💑
:couplekiss	💏
:cow2	🐄
:cow:	🐮
:cowboy	🤠
:crab	🦀
:credit_card	💳
:crescent_moon	🌙
:cricket:	🦗
:cricket_bat_ball	🏏
:cricket_game	🏏
:crocodile	🐊
:croissant	🥐
:crossed_flags	🎌
:crown	👑
:cry:	😢
:crying_cat_face	😿
:crystal_ball	🔮
:cucumber	🥒
:cup_with_straw	🥤
:cupcake	🧁
:cupid	💘
:curling_stone	🥌
:curly_haired	🦱
:curly_loop	➰
:currency_exchange	💱
:curry	🍛
:custard	🍮
:customs	🛃
:cut_of_meat	🥩
:cyclone	🌀
:dancer:	💃
:dancers	👯
:dango	🍡
:dart	🎯
:dash	💨
:date	📅
:deaf_person	🧏
:deciduous_tree	🌳
:deer	🦌
:department_store	🏬
:detective	🕵
:diamond_shape_with_a_dot_inside	💠
:disappointed:	😞
:disappointed_relieved	😥
:disguised_face	🥸
:diving_mask	🤿
:diya_lamp	🪔
:dizzy:	💫
:dizzy_face	😵
:dna	🧬
:do_not_litter	🚯
:dodo	🦤
:dog2	🐕
:dog:	🐶
:dollar	💵
:dolls	🎎
:dolphin	🐬
:door	🚪
:doughnut	🍩
:dragon:	🐉
:dragon_face	🐲
:dress	👗
:dromedary_camel	🐪
:drool:	🤤
:drooling_face	🤤
:drop_of_blood	🩸
:droplet	💧
:drum:	🥁
:drum_with_drumsticks	🥁
:duck	🦆
:dumpling	🥟
:dvd	📀
:e-mail	📧
:eagle	🦅
:ear:	👂
:ear_of_rice	🌾
:ear_with_hearing_aid	🦻
:earth_africa	🌍
:earth_americas	🌎
:earth_asia	🌏
:egg:	🥚
:eggplant	🍆
:electric_plug	🔌
:elephant	🐘
:elevator	🛗
:elf	🧝
:email	📧
:end	🔚
:envelope_with_arrow	📩
:euro:	💶
:european_castle	🏰
:european_post_office	🏤
:evergreen_tree	🌲
:exclamation	❗
:expecting_woman	🤰
:exploding_head	🤯
:expressionless	😑
:eyeglasses	👓
:eyes	👀
:face_palm	🤦
:face_vomiting	🤮
:face_with_cowboy_hat	🤠
:face_with_hand_over_mouth	🤭
:face_with_head_bandage	🤕
:face_with_monocle	🧐
:face_with_raised_eyebrow	🤨
:face_with_rolling_eyes	🙄
:face_with_symbols_over_mouth	🤬
:face_with_thermometer	🤒
:facepalm	🤦
:factory	🏭
:fairy	🧚
:falafel	🧆
:fallen_leaf	🍂
:family	👪
:fast_forward	⏩
:fax	📠
:fearful	😨
:feather	🪶
:feet	🐾
:fencer	🤺
:fencing	🤺
:ferris_wheel	🎡
:field_hockey	🏑
:file_folder	📁
:fingers_crossed	🤞
:fire:	🔥
:fire_engine	🚒
:fire_extinguisher	🧯
:firecracker	🧨
:fireworks	🎆
:first_place:	🥇
:first_place_medal	🥇
:first_quarter_moon:	🌓
:first_quarter_moon_with_face	🌛
:fish:	🐟
:fish_cake	🍥
:fishing_pole_and_fish	🎣
:fist	✊
:flag_black	🏴
:flags	🎏
:flame	🔥
:flamingo	🦩
:flan	🍮
:flashlight	🔦
:flatbread	🫓
:floppy_disk	💾
:flower_playing_cards	🎴
:flushed	😳
:fly:	🪰
:flying_disc	🥏
:flying_saucer	🛸
:foggy	🌁
:fondue	🫕
:foot:	🦶
:football	🏈
:footprints	👣
:fork_and_knife	🍴
:fortune_cookie	🥠
:fountain	⛲
:four_leaf_clover	🍀
:fox:	🦊
:fox_face	🦊
:free	🆓
:french_bread	🥖
:fried_shrimp	🍤
:fries	🍟
:frog	🐸
:frowning	😦
:fuelpump	⛽
:full_moon:	🌕
:full_moon_with_face	🌝
:game_die	🎲
:garlic	🧄
:gem:	💎
:gemini	♊
:genie	🧞
:ghost	👻
:gift:	🎁
:gift_heart	💝
:giraffe	🦒
:girl	👧
:glass_of_milk	🥛
:globe_with_meridians	🌐
:gloves	🧤
:goal:	🥅
:goal_net	🥅
:goat	🐐
:goggles	🥽
:golf:	⛳
:golfer	🏌
:gorilla	🦍
:grandma	👵
:grapes	🍇
:green_apple	🍏
:green_book	📗
:green_circle	🟢
:green_heart	💚
:green_salad	🥗
:green_square	🟩
:grey_exclamation	❕
:grey_question	❔
:grimacing	😬
:grin:	😁
:grinning	😀
:guard:	💂
:guardsman	💂
:guide_dog	🦮
:guitar	🎸
:gun	🔫
:haircut	💇
:hamburger	🍔
:hammer	🔨
:hamster	🐹
:hand_splayed	🖐
:hand_with_index_and_middle_finger_crossed	🤞
:handbag	👜
:handball	🤾
:handshake	🤝
:hankey	💩
:hatched_chick	🐥
:hatching_chick	🐣
:head_bandage	🤕
:headphones	🎧
:headstone	🪦
:hear_no_evil	🙉
:heart_decoration	💟
:heart_eyes:	😍
:heart_eyes_cat	😻
:heartbeat	💓
:heartpulse	💗
:heavy_division_sign	➗
:heavy_dollar_sign	💲
:heavy_minus_sign	➖
:heavy_plus_sign	➕
:hedgehog	🦔
:helicopter	🚁
:herb	🌿
:hibiscus	🌺
:high_brightness	🔆
:high_heel	👠
:hiking_boot	🥾
:hindu_temple	🛕
:hippopotamus	🦛
:hockey	🏒
:honey_pot	🍯
:hook	🪝
:horse:	🐴
:horse_racing	🏇
:hospital	🏥
:hot_dog	🌭
:hot_face	🥵
:hotdog	🌭
:hotel	🏨
:hourglass:	⌛
:hourglass_flowing_sand	⏳
:house:	🏠
:house_with_garden	🏡
:hugging:	🤗
:hugging_face	🤗
:hushed	😯
:hut	🛖
:ice_cream	🍨
:ice_cube	🧊
:icecream	🍦
:id:	🆔
:ideograph_advantage	🉐
:imp	👿
:inbox_tray	📥
:incoming_envelope	📨
:information_desk_person	💁
:innocent	😇
:izakaya_lantern	🏮
:jack_o_lantern	🎃
:japan:	🗾
:japanese_castle	🏯
:japanese_goblin	👺
:japanese_ogre	👹
:jeans	👖
:jigsaw	🧩
:joy:	😂
:joy_cat	😹
:juggler	🤹
:juggling	🤹
:kaaba	🕋
:kangaroo	🦘
:karate_uniform	🥋
:kayak	🛶
:key:	🔑
:keycap_ten	🔟
:kimono	👘
:kiss:	💋
:kissing:	😗
:kissing_cat	😽
:kissing_closed_eyes	😚
:kissing_heart	😘
:kissing_smiling_eyes	😙
:kite	🪁
:kiwi:	🥝
:kiwifruit	🥝
:knife	🔪
:knot	🪢
:koala	🐨
:koko	🈁
:lab_coat	🥼
:lacrosse	🥍
:ladder	🪜
:lady_beetle	🐞
:large_blue_diamond	🔷
:large_orange_diamond	🔶
:last_quarter_moon:	🌗
:last_quarter_moon_with_face	🌜
:laughing	😆
:leafy_green	🥬
:leaves	🍃
:ledger	📒
:left_facing_fist	🤛
:left_fist	🤛
:left_luggage	🛅
:leg	🦵
:lemon	🍋
:leo:	♌
:leopard	🐆
:liar	🤥
:libra	♎
:lifter	🏋
:light_rail	🚈
:link	🔗
:lion:	🦁
:lion_face	🦁
:lips:	👄
:lipstick	💄
:lizard	🦎
:llama	🦙
:lobster	🦞
:lock:	🔒
:lock_with_ink_pen	🔏
:lollipop	🍭
:long_drum	🪘
:loop	➿
:loud_sound	🔊
:loudspeaker	📢
:love_hotel	🏩
:love_letter	💌
:love_you_gesture	🤟
:low_brightness	🔅
:luggage	🧳
:lungs	🫁
:lying_face	🤥
:mag:	🔍
:mag_right	🔎
:mage	🧙
:magic_wand	🪄
:magnet	🧲
:mahjong	🀄
:mailbox:	📫
:mailbox_closed	📪
:mailbox_with_mail	📬
:mailbox_with_no_mail	📭
:male_dancer	🕺
:mammoth	🦣
:man:	👨
:man_dancing	🕺
:man_with_chinese_cap	👲
:man_with_gua_pi_mao	👲
:man_with_turban	👳
:mango	🥭
:mans_shoe	👞
:manual_wheelchair	🦽
:maple_leaf	🍁
:martial_arts_uniform	🥋
:mask	😷
:massage	💆
:mate	🧉
:meat_on_bone	🍖
:mechanical_arm	🦾
:mechanical_leg	🦿
:medal	🏅
:mega	📣
:melon	🍈
:memo	📝
:menorah	🕎
:mens	🚹
:merperson	🧜
:metal	🤘
:metro	🚇
:microbe	🦠
:microphone	🎤
:microscope	🔬
:middle_finger	🖕
:military_helmet	🪖
:milk:	🥛
:milky_way	🌌
:minibus	🚐
:minidisc	💽
:mirror	🪞
:mobile_phone:	📱
:mobile_phone_off	📴
:money_mouth:	🤑
:money_mouth_face	🤑
:money_with_wings	💸
:moneybag	💰
:monkey:	🐒
:monkey_face	🐵
:monorail	🚝
:moon_cake	🥮
:mortar_board	🎓
:mosque	🕌
:mosquito	🦟
:mother_christmas	🤶
:motor_scooter	🛵
:motorbike	🛵
:motorized_wheelchair	🦼
:mount_fuji	🗻
:mountain_bicyclist	🚵
:mountain_cableway	🚠
:mountain_railway	🚞
:mouse2	🐁
:mouse:	🐭
:mouse_trap	🪤
:movie_camera	🎥
:moyai	🗿
:mrs_claus	🤶
:muscle	💪
:mushroom	🍄
:musical_keyboard	🎹
:musical_note	🎵
:musical_score	🎼
:mute	🔇
:nail_care	💅
:name_badge	📛
:nauseated_face	🤢
:nazar_amulet	🧿
:necktie	👔
:negative_squared_cross_mark	❎
:nerd:	🤓
:nerd_face	🤓
:nesting_dolls	🪆
:neutral_face	😐
:new:	🆕
:new_moon:	🌑
:new_moon_with_face	🌚
:newspaper	📰
:ng	🆖
:night_with_stars	🌃
:ninja	🥷
:no_bell	🔕
:no_bicycles	🚳
:no_entry:	⛔
:no_entry_sign	🚫
:no_good	🙅
:no_mobile_phones	📵
:no_mouth	😶
:no_pedestrians	🚷
:no_smoking	🚭
:non-potable_water	🚱
:nose	👃
:notebook:	📓
:notebook_with_decorative_cover	📔
:notes	🎶
:nut_and_bolt	🔩
:o:	⭕
:ocean	🌊
:octagonal_sign	🛑
:octopus	🐙
:oden	🍢
:office	🏢
:ok:	🆗
:ok_hand	👌
:ok_woman	🙆
:older_adult	🧓
:older_man	👴
:older_woman	👵
:olive	🫒
:on:	🔛
:oncoming_automobile	🚘
:oncoming_bus	🚍
:oncoming_police_car	🚔
:oncoming_taxi	🚖
:one_piece_swimsuit	🩱
:onion	🧅
:open_file_folder	📂
:open_hands	👐
:open_mouth	😮
:ophiuchus	⛎
:orange_book	📙
:orange_circle	🟠
:orange_heart	🧡
:orange_square	🟧
:orangutan	🦧
:otter	🦦
:outbox_tray	📤
:owl	🦉
:ox	🐂
:oyster	🦪
:package	📦
:paella	🥘
:page_facing_up	📄
:page_with_curl	📃
:pager	📟
:palm_tree	🌴
:palms_up_together	🤲
:pancakes	🥞
:panda_face	🐼
:paperclip	📎
:parachute	🪂
:parrot	🦜
:partly_sunny	⛅
:partying_face	🥳
:passport_control	🛂
:paw_prints	🐾
:peach	🍑
:peacock	🦚
:peanuts	🥜
:pear	🍐
:pencil	📝
:penguin	🐧
:pensive	😔
:people_hugging	🫂
:people_with_bunny_ears_partying	👯
:people_wrestling	🤼
:performing_arts	🎭
:persevere	😣
:person_biking	🚴
:person_bouncing_ball	⛹
:person_bowing	🙇
:person_climbing	🧗
:person_doing_cartwheel	🤸
:person_facepalming	🤦
:person_fencing	🤺
:person_frowning	🙍
:person_gesturing_no	🙅
:person_gesturing_ok	🙆
:person_getting_haircut	💇
:person_getting_massage	💆
:person_golfing	🏌
:person_in_lotus_position	🧘
:person_in_steamy_room	🧖
:person_in_tuxedo	🤵
:person_juggling	🤹
:person_kneeling	🧎
:person_lifting_weights	🏋
:person_mountain_biking	🚵
:person_playing_handball	🤾
:person_playing_water_polo	🤽
:person_pouting	🙎
:person_raising_hand	🙋
:person_rowing_boat	🚣
:person_running	🏃
:person_shrugging	🤷
:person_standing	🧍
:person_surfing	🏄
:person_swimming	🏊
:person_tipping_hand	💁
:person_walking	🚶
:person_wearing_turban	👳
:person_with_ball	⛹
:person_with_blond_hair	👱
:person_with_pouting_face	🙎
:person_with_veil	👰
:petri_dish	🧫
:pickup_truck	🛻
:pie	🥧
:pig2	🐖
:pig:	🐷
:pig_nose	🐽
:pill	💊
:pinched_fingers	🤌
:pinching_hand	🤏
:pineapple	🍍
:ping_pong	🏓
:pisces	♓
:pizza	🍕
:piñata	🪅
:placard	🪧
:place_of_worship	🛐
:pleading_face	🥺
:plunger	🪠
:point_down	👇
:point_left	👈
:point_right	👉
:point_up_2	👆
:police_car	🚓
:police_officer	👮
:poo:	💩
:poodle	🐩
:poop	💩
:popcorn	🍿
:post_office	🏣
:postal_horn	📯
:postbox	📮
:potable_water	🚰
:potato	🥔
:potted_plant	🪴
:pouch	👝
:poultry_leg	🍗
:pound	💷
:pouting_cat	😾
:pray:	🙏
:prayer_beads	📿
:pregnant_woman	🤰
:pretzel	🥨
:prince:	🤴
:princess	👸
:probing_cane	🦯
:pudding	🍮
:punch	👊
:purple_circle	🟣
:purple_heart	💜
:purple_square	🟪
:purse	👛
:pushpin	📌
:put_litter_in_its_place	🚮
:question	❓
:rabbit2	🐇
:rabbit:	🐰
:raccoon	🦝
:racehorse	🐎
:radio:	📻
:radio_button	🔘
:rage	😡
:railway_car	🚃
:rainbow	🌈
:raised_back_of_hand	🤚
:raised_hand:	✋
:raised_hand_with_fingers_splayed	🖐
:raised_hand_with_part_between_middle_and_ring_fingers	🖖
:raised_hands	🙌
:raising_hand	🙋
:ram:	🐏
:ramen	🍜
:rat	🐀
:razor	🪒
:receipt	🧾
:red_car	🚗
:red_circle	🔴
:red_envelope	🧧
:red_haired	🦰
:red_square	🟥
:regional_indicator_a	🇦
:regional_indicator_b	🇧
:regional_indicator_c	🇨
:regional_indicator_d	🇩
:regional_indicator_e	🇪
:regional_indicator_f	🇫
:regional_indicator_g	🇬
:regional_indicator_h	🇭
:regional_indicator_i	🇮
:regional_indicator_j	🇯
:regional_indicator_k	🇰
:regional_indicator_l	🇱
:regional_indicator_m	🇲
:regional_indicator_n	🇳
:regional_indicator_o	🇴
:regional_indicator_p	🇵
:regional_indicator_q	🇶
:regional_indicator_r	🇷
:regional_indicator_s	🇸
:regional_indicator_t	🇹
:regional_indicator_u	🇺
:regional_indicator_v	🇻
:regional_indicator_w	🇼
:regional_indicator_x	🇽
:regional_indicator_y	🇾
:regional_indicator_z	🇿
:relieved	😌
:repeat:	🔁
:repeat_one	🔂
:restroom	🚻
:reversed_hand_with_middle_finger_extended	🖕
:revolving_hearts	💞
:rewind	⏪
:rhino:	🦏
:rhinoceros	🦏
:ribbon	🎀
:rice:	🍚
:rice_ball	🍙
:rice_cracker	🍘
:rice_scene	🎑
:right_facing_fist	🤜
:right_fist	🤜
:ring:	💍
:ringed_planet	🪐
:robot:	🤖
:robot_face	🤖
:rock:	🪨
:rocket	🚀
:rofl	🤣
:roll_of_paper	🧻
:roller_coaster	🎢
:roller_skate	🛼
:rolling_eyes	🙄
:rolling_on_the_floor_laughing	🤣
:rooster	🐓
:rose	🌹
:rotating_light	🚨
:round_pushpin	📍
:rowboat	🚣
:rugby_football	🏉
:runner	🏃
:running_shirt_with_sash	🎽
:safety_pin	🧷
:safety_vest	🦺
:sagittarius	♐
:sailboat	⛵
:sake	🍶
:salad	🥗
:salt	🧂
:sandal	👡
:sandwich	🥪
:santa	🎅
:sari	🥻
:satellite	📡
:satisfied	😆
:sauropod	🦕
:saxophone	🎷
:scarf	🧣
:school:	🏫
:school_satchel	🎒
:scooter	🛴
:scorpion	🦂
:scorpius	♏
:scream:	😱
:scream_cat	🙀
:screwdriver	🪛
:scroll	📜
:seal	🦭
:seat	💺
:second_place:	🥈
:second_place_medal	🥈
:see_no_evil	🙈
:seedling	🌱
:selfie	🤳
:sewing_needle	🪡
:shaking_hands	🤝
:shallow_pan_of_food	🥘
:shark	🦈
:shaved_ice	🍧
:sheep	🐑
:shell:	🐚
:shelled_peanut	🥜
:ship	🚢
:shirt	👕
:shit	💩
:shopping_cart	🛒
:shopping_trolley	🛒
:shorts	🩳
:shower	🚿
:shrimp	🦐
:shrug	🤷
:shushing_face	🤫
:sick	🤢
:sign_of_the_horns	🤘
:signal_strength	📶
:six_pointed_star	🔯
:skateboard	🛹
:skeleton	💀
:ski	🎿
:skull	💀
:skunk	🦨
:sled	🛷
:sleeping:	😴
:sleeping_accommodation	🛌
:sleepy	😪
:sleuth_or_spy	🕵
:slight_frown	🙁
:slight_smile	🙂
:slightly_frowning_face	🙁
:slightly_smiling_face	🙂
:slot_machine	🎰
:sloth	🦥
:small_blue_diamond	🔹
:small_orange_diamond	🔸
:small_red_triangle:	🔺
:small_red_triangle_down	🔻
:smile:	😄
:smile_cat	😸
:smiley:	😃
:smiley_cat	😺
:smiling_face_with_3_hearts	🥰
:smiling_face_with_tear	🥲
:smiling_imp	😈
:smirk:	😏
:smirk_cat	😼
:smoking	🚬
:snail	🐌
:snake	🐍
:sneeze	🤧
:sneezing_face	🤧
:snowboarder	🏂
:snowman	⛄
:soap	🧼
:sob	😭
:soccer	⚽
:socks	🧦
:softball	🥎
:soon	🔜
:sos	🆘
:sound	🔉
:space_invader	👾
:spaghetti	🍝
:sparkler	🎇
:sparkles	✨
:sparkling_heart	💖
:speak_no_evil	🙊
:speaker	🔈
:speech_balloon	💬
:speedboat	🚤
:sponge	🧽
:spoon	🥄
:sports_medal	🏅
:spy	🕵
:squeeze_bottle	🧴
:squid	🦑
:star2	🌟
:star:	⭐
:star_struck	🤩
:stars	🌠
:station	🚉
:statue_of_liberty	🗽
:steam_locomotive	🚂
:stethoscope	🩺
:stew	🍲
:stop_sign	🛑
:straight_ruler	📏
:strawberry	🍓
:stuck_out_tongue:	😛
:stuck_out_tongue_closed_eyes	😝
:stuck_out_tongue_winking_eye	😜
:stuffed_flatbread	🥙
:stuffed_pita	🥙
:sun_with_face	🌞
:sunflower	🌻
:sunglasses	😎
:sunrise:	🌅
:sunrise_over_mountains	🌄
:superhero	🦸
:supervillain	🦹
:surfer	🏄
:sushi	🍣
:suspension_railway	🚟
:swan	🦢
:sweat:	😓
:sweat_drops	💦
:sweat_smile	😅
:sweet_potato	🍠
:swimmer	🏊
:symbols	🔣
:synagogue	🕍
:syringe	💉
:t_rex	🦖
:table_tennis	🏓
:taco	🌮
:tada	🎉
:takeout_box	🥡
:tamale	🫔
:tanabata_tree	🎋
:tangerine	🍊
:taurus	♉
:taxi	🚕
:tea:	🍵
:teapot	🫖
:teddy_bear	🧸
:telephone_receiver	📞
:telescope	🔭
:tennis	🎾
:tent	⛺
:test_tube	🧪
:thermometer_face	🤒
:thinking:	🤔
:thinking_face	🤔
:third_place:	🥉
:third_place_medal	🥉
:thong_sandal	🩴
:thought_balloon	💭
:thread	🧵
:thumbdown	👎
:thumbsdown	👎
:thumbsup	👍
:thumbup	👍
:ticket	🎫
:tiger2	🐅
:tiger:	🐯
:tired_face	😫
:toilet	🚽
:tokyo_tower	🗼
:tomato	🍅
:tone1	🏻
:tone2	🏼
:tone3	🏽
:tone4	🏾
:tone5	🏿
:tongue	👅
:toolbox	🧰
:tooth:	🦷
:toothbrush	🪥
:top:	🔝
:tophat	🎩
:tractor	🚜
:traffic_light	🚥
:train2	🚆
:train:	🚋
:tram	🚊
:transgender_symbol	⚧
:triangular_flag_on_post	🚩
:triangular_ruler	📐
:trident	🔱
:triumph	😤
:trolleybus	🚎
:trophy	🏆
:tropical_drink	🍹
:tropical_fish	🐠
:truck	🚚
:trumpet	🎺
:tulip	🌷
:tumbler_glass	🥃
:turkey	🦃
:turtle	🐢
:tv	📺
:twisted_rightwards_arrows	🔀
:two_hearts	💕
:two_men_holding_hands	👬
:two_women_holding_hands	👭
:u5272	🈹
:u5408	🈴
:u55b6	🈺
:u6307	🈯
:u6709	🈶
:u6e80	🈵
:u7121	🈚
:u7533	🈸
:u7981	🈲
:u7a7a	🈳
:umbrella	☔
:unamused	😒
:underage	🔞
:unicorn:	🦄
:unicorn_face	🦄
:unlock	🔓
:up:	🆙
:upside_down:	🙃
:upside_down_face	🙃
:vampire	🧛
:vertical_traffic_light	🚦
:vhs	📼
:vibration_mode	📳
:video_camera	📹
:video_game	🎮
:violin	🎻
:virgo	♍
:volcano	🌋
:volleyball	🏐
:vs	🆚
:vulcan	🖖
:waffle	🧇
:walking	🚶
:waning_crescent_moon	🌘
:waning_gibbous_moon	🌖
:watch	⌚
:water_buffalo	🐃
:water_polo	🤽
:watermelon	🍉
:wave	👋
:waving_black_flag	🏴
:waxing_crescent_moon	🌒
:waxing_gibbous_moon	🌔
:wc	🚾
:weary	😩
:wedding	💒
:weight_lifter	🏋
:whale2	🐋
:whale:	🐳
:wheelchair	♿
:whisky	🥃
:white_check_mark	✅
:white_circle	⚪
:white_flower	💮
:white_haired	🦳
:white_heart	🤍
:white_large_square	⬜
:white_medium_small_square	◽
:white_square_button	🔳
:wilted_flower	🥀
:wilted_rose	🥀
:wind_chime	🎐
:window	🪟
:wine_glass	🍷
:wink	😉
:wolf	🐺
:woman:	👩
:woman_with_headscarf	🧕
:womans_clothes	👚
:womans_flat_shoe	🥿
:womans_hat	👒
:womens	🚺
:wood	🪵
:woozy_face	🥴
:worm	🪱
:worried	😟
:worship_symbol	🛐
:wrench	🔧
:wrestlers	🤼
:wrestling	🤼
:x	❌
:yarn	🧶
:yawning_face	🥱
:yellow_circle	🟡
:yellow_heart	💛
:yellow_square	🟨
:yen	💴
:yo_yo	🪀
:yum	😋
:zany_face	🤪
:zap	⚡
:zebra	🦓
:zipper_mouth:	🤐
:zipper_mouth_face	🤐
:zombie	🧟
:zzz	💤
